#######################################
# Syntax Coloring Map For ADDAC -> !! This still needs to be finished!!!
#######################################
# Always remember that it's TABS AND NOT SPACES!!!!!
#######################################
# Datatypes (KEYWORD1)
#######################################
StandardCplusplus	KEYWORD1
vector	KEYWORD1

ADDAC	KEYWORD1
ADDAC.h	KEYWORD1
VCC	KEYWORD1

ADDAC_Comparator.h	KEYWORD1
ADDAC_Comparator	KEYWORD1

ADDAC_LFO.h	KEYWORD1
ADDAC_LFO	KEYWORD1

ADDAC_Adsr.h	KEYWORD1
ADDAC_Adsr	KEYWORD1

ADDAC_AD.h	KEYWORD1
ADDAC_AD	KEYWORD1

ADDAC_Env.h	KEYWORD1
ADDAC_Env	KEYWORD1

ADDAC_Liss.h	KEYWORD1
ADDAC_Liss	KEYWORD1

ADDAC_Physics.h	KEYWORD1
ADDAC_Physics	KEYWORD1

ADDAC_Quantizer.h	KEYWORD1
ADDAC_Quantizer	KEYWORD1

ADDAC_Quad.h	KEYWORD1
ADDAC_Quad	KEYWORD1

ADDAC_Smooth.h	KEYWORD1
ADDAC_Smooth	KEYWORD1

ADDAC_GateDelay.h	KEYWORD1
ADDAC_GateDelay	KEYWORD1

ADDAC_CVlooper.h	KEYWORD1
ADDAC_CVlooper	KEYWORD1

ADDAC_Random.h	KEYWORD1
ADDAC_Random	KEYWORD1

ADDAC_Lin2Log.h	KEYWORD1
ADDAC_Lin2Log	KEYWORD1

ADDAC_CvToMidi.h	KEYWORD1
ADDAC_CvToMidi	KEYWORD1

ADDAC_DMX.h	KEYWORD1
ADDAC_DMX	KEYWORD1

ADDAC_Flock.h	KEYWORD1
ADDAC_Flock	KEYWORD1

ADDAC_Midi.h	KEYWORD1
ADDAC_Midi	KEYWORD1

ADDAC_Ntof.h	KEYWORD1
ADDAC_Ntof	KEYWORD1

ADDAC_Probabilistic.h	KEYWORD1
ADDAC_Probabilistic	KEYWORD1

ADDAC_PVector.h	KEYWORD1
ADDAC_PVector	KEYWORD1

ADDAC_SuperFormula.h	KEYWORD1
ADDAC_SuperFormula	KEYWORD1

ADDAC_Timer.h	KEYWORD1
ADDAC_Timer	KEYWORD1

ADDAC_VCO.h	KEYWORD1
ADDAC_VCO	KEYWORD1


ADDAC_Pendulum.h	KEYWORD1
ADDAC_Pendulum	KEYWORD1


ADDAC_DMX.h	KEYWORD1
ADDAC_DMX	KEYWORD1


ADDAC_PulseGen.h	KEYWORD1
ADDAC_PulseGen	KEYWORD1




#######################################
# Methods and Functions (KEYWORD2)
#######################################

setup		KEYWORD2
update	KEYWORD2
readMODEswitch	KEYWORD2
readMODE	KEYWORD2
readSUBMODE	KEYWORD2
write		KEYWORD2
WriteChannel	KEYWORD2
ReadManuals	KEYWORD2
PrintManuals	KEYWORD2
ReadManual	KEYWORD2
PrintManual	KEYWORD2
ReadCvs	KEYWORD2
PrintCvs	KEYWORD2
ReadCv	KEYWORD2
PrintCv 	KEYWORD2
ReadGates	KEYWORD2
PrintGates	KEYWORD2
ReadGate	KEYWORD2
PrintGate	KEYWORD2
WriteGates	KEYWORD2
WriteGatesStraight	KEYWORD2
mixerMode	KEYWORD2

A	KEYWORD2
B	KEYWORD2
C	KEYWORD2

MODE	KEYWORD2
SUBMODE	KEYWORD2
DACvolts	KEYWORD2
cvInAvals	KEYWORD2
cvValuesA	KEYWORD2
cvValuesAMapped	KEYWORD2
cvInBvals	KEYWORD2
cvValuesB	KEYWORD2
cvValuesBMapped	KEYWORD2

adsrMode	KEYWORD2
adsrLogExpMode	KEYWORD2
AD_update	KEYWORD2
ADSR_update	KEYWORD2
AD_trigger	KEYWORD2
AD_release	KEYWORD2

envMode	KEYWORD2

addPoint	KEYWORD2
MultiEnvLoop	KEYWORD2
PrintMultiEnv	KEYWORD2

setInc	KEYWORD2

CVstream	KEYWORD2
SINupdate	KEYWORD2
COSINupdate	KEYWORD2

Comparator	KEYWORD2

bump	KEYWORD2

quantize	KEYWORD2
Note	KEYWORD2
amp1	KEYWORD2
amp2	KEYWORD2
amp3	KEYWORD2
amp4	KEYWORD2

record	KEYWORD2
loopSize	KEYWORD2
clearRecord	KEYWORD2
Play	KEYWORD2
overdub	KEYWORD2

GateDelayRise	KEYWORD2
GateDelayFall	KEYWORD2

Smooth	KEYWORD2

AND	KEYWORD2
OR	KEYWORD2
NOR	KEYWORD2
NAND	KEYWORD2
XOR	KEYWORD2
XNOR	KEYWORD2


simpleUpdate	KEYWORD2
stepUpdate	KEYWORD2
simpleStepUpdate	KEYWORD2
clock	KEYWORD2
reset	KEYWORD2
checkClock	KEYWORD2
checkChangeState	KEYWORD2

calc	KEYWORD2

setBrownianRandom	KEYWORD2
setBrownianTime	KEYWORD2
setStepReset	KEYWORD2

addChannel	KEYWORD2
fadeIN	KEYWORD2
fadeOUT	KEYWORD2
strobe	KEYWORD2
set	KEYWORD2
DMXstream	KEYWORD2
DMXA	KEYWORD2
DMXB	KEYWORD2


useCC	KEYWORD2
useNotes	KEYWORD2
CCvals	KEYWORD2
notesOn	KEYWORD2
notesVelocity	KEYWORD2
totalNotes	KEYWORD2
monoNote	KEYWORD2
monoVelocity	KEYWORD2

setGlide	KEYWORD2
out1	KEYWORD2
out2	KEYWORD2
out3	KEYWORD2
out4	KEYWORD2
out5	KEYWORD2

add	KEYWORD2
sub	KEYWORD2
mult	KEYWORD2
div	KEYWORD2
normalize	KEYWORD2


superformula	KEYWORD2
setPingPongMode	KEYWORD2
setLoopMin	KEYWORD2
setLoopMax	KEYWORD2
getX	KEYWORD2
getY	KEYWORD2


initialize	KEYWORD2
startup	KEYWORD2
VCO_update	KEYWORD2

updateLin	KEYWORD2
updateLogExpMode	KEYWORD2
trigger	KEYWORD2
release	KEYWORD2


fadeIn	KEYWORD2
fadeOut	KEYWORD2



#
#######################################
# Constants (LITERAL1)
#######################################

addacMaxResolution	LITERAL1
UNKNOWN	LITERAL1
REPEAT	LITERAL1
RISE	LITERAL1
FALL	LITERAL1
CHANGE	LITERAL1
x	LITERAL1
y	LITERAL1
z	LITERAL1

DEBUG	LITERAL1
